0,56,16
161,20,0
0,73,209
8 8 8 8 8 8 8 8 8 8 
8 3 3 3 8 8 3 3 3 8 
11 11 11 11 11 11 11 11 11 11 
10 10 10 10 10 10 10 10 10 10 
9 9 9 9 9 9 9 9 9 9 
8 8 8 8 8 8 8 8 8 8 
7 7 7 7 7 7 7 7 7 7 
6 6 6 6 6 6 6 6 6 6 
5 5 5 5 5 5 5 5 5 5 
4 4 4 4 3 3 4 4 4 4 
2 2 2 2 2 2 2 2 2 2 
1 1 1 1 1 1 1 1 1 1 
