0,56,16
161,20,0
0,73,209
0 1 1 1 0 0 1 0 1 0 
1 1 1 0 0 1 1 1 1 1 
0 1 0 0 0 1 0 1 0 0 
0 0 0 0 0 0 0 0 0 0 
0 0 5 0 0 0 0 0 4 4 
0 5 5 9 0 0 0 4 4 4 
0 5 5 5 0 0 0 0 8 8 
0 0 8 0 0 0 0 0 8 6 
0 0 8 0 0 0 0 0 8 6 
0 0 8 0 0 0 0 0 8 8 
0 0 8 0 0 0 0 0 8 8 
0 0 8 0 0 0 0 0 8 8 
