(0,0,0)
(255,255,255)
(0,0,0)
1 1 1 1 1 1 1 1 1 1 
1 0 0 0 0 0 0 0 0 0 
1 0 0 0 0 0 0 0 0 0 
1 0 0 5 5 5 5 5 0 0 
1 0 0 5 3 6 3 5 0 0 
1 0 0 5 6 6 6 5 0 0 
1 0 0 5 6 6 6 5 0 0 
1 0 0 5 6 3 6 5 0 0 
1 0 0 5 5 5 5 5 0 0 
1 0 0 0 0 1 0 0 0 0 
1 0 0 0 1 1 1 0 0 0 
1 0 0 0 0 1 0 0 0 0 
